###### CONSTRAINTS ######
!CC	Not(LexiconPosTag("CC"))
!CD	Not(LexiconPosTag("CD"))
!DT	Not(LexiconPosTag("DT"))
!EX	Not(LexiconPosTag("EX"))
!IN	Not(LexiconPosTag("IN"))
!MD	Not(LexiconPosTag("MD"))
!P	Not(LexiconPosTag("P"))
!PDT	Not(LexiconPosTag("PDT"))
!POS	Not(LexiconPosTag("POS"))
!PRP	Not(LexiconPosTag("PRP"))
!PRP$	Not(LexiconPosTag("PRP$"))
!RP	Not(LexiconPosTag("RP"))
!P	Not(LexiconPosTag("P"))
!TO	Not(LexiconPosTag("TO"))
!WDT	Not(LexiconPosTag("WDT"))
!WP	Not(LexiconPosTag("WP"))
!WP$	Not(LexiconPosTag("WP$"))
!WRB	Not(LexiconPosTag("WRB"))
!FW	HasClosedClassesOnly()
!JJ	HasClosedClassesOnly()
!JJR	HasClosedClassesOnly()
!JJS	HasClosedClassesOnly()
!LS	HasClosedClassesOnly()
!NN	HasClosedClassesOnly()
!NNS	HasClosedClassesOnly()
!NNP	HasClosedClassesOnly()
!NNPS	HasClosedClassesOnly()
!RB	HasClosedClassesOnly()
!RBR	HasClosedClassesOnly()
!RBS	HasClosedClassesOnly()
!SYM	HasClosedClassesOnly()
!UH	HasClosedClassesOnly()
!VB	HasClosedClassesOnly()
!VBD	HasClosedClassesOnly()
!VBG	HasClosedClassesOnly()
!VBN	HasClosedClassesOnly()
!VBP	HasClosedClassesOnly()
!VBZ	HasClosedClassesOnly()