PatternWordForm
PrevTokenPosTag	OnlyTrue(LexiconPosTag(PatternOffset(-1), PosTagSet))
NextTokenPosTag	OnlyTrue(IfThenElse(WordForm(PatternOffset(1))=="'",LexiconPosTag(PatternOffset(2), PosTagSet),LexiconPosTag(PatternOffset(1), PosTagSet)))
PrevTokenUnknown	OnlyTrue(UnknownWord(PatternOffset(-1)))
TokenP2Unknown|TokenP1WordForm	ConcatNoNulls(ToStringNoNulls(OnlyTrue(UnknownWord(PatternOffset(-2)))), WordForm(PatternOffset(-1)))
NextTokenUnknown	OnlyTrue(IfThenElse(WordForm(PatternOffset(1))=="'",UnknownWord(PatternOffset(2)),UnknownWord(PatternOffset(1))))
TokenN1WordForm|TokenN2Unknown	IfThenElse(WordForm(PatternOffset(1))=="'",ConcatNoNulls(WordForm(PatternOffset(2)), ToStringNoNulls(OnlyTrue(UnknownWord(PatternOffset(3))))),ConcatNoNulls(WordForm(PatternOffset(1)), ToStringNoNulls(OnlyTrue(UnknownWord(PatternOffset(2))))))
PrevTokenAllPosTags	ConcatNoNulls(LexiconAllPosTags(PatternOffset(-1)))
TokenP2AllPosTags|TokenP1WordForm	ConcatNoNulls(LexiconAllPosTags(PatternOffset(-2)), WordForm(PatternOffset(-1)))
TokenP2AllPosTags|TokenP1AllPosTags	ConcatNoNulls(LexiconAllPosTags(PatternOffset(-2)), LexiconAllPosTags(PatternOffset(-1)))
TokenP2WordForm|TokenP1AllPosTags	ConcatNoNulls(WordForm(PatternOffset(-2)), LexiconAllPosTags(PatternOffset(-1)))
NextTokenAllPosTags	ConcatNoNulls(IfThenElse(WordForm(PatternOffset(1))=="'",LexiconAllPosTags(PatternOffset(2)),LexiconAllPosTags(PatternOffset(1))))
TokenN1WordForm|TokenN2AllPosTags	IfThenElse(WordForm(PatternOffset(1))=="'",ConcatNoNulls(WordForm(PatternOffset(2)), LexiconAllPosTags(PatternOffset(3))),ConcatNoNulls(WordForm(PatternOffset(1)), LexiconAllPosTags(PatternOffset(2))))
TokenN1AllPosTags|TokenN2AllPosTags	IfThenElse(WordForm(PatternOffset(1))=="'",ConcatNoNulls(LexiconAllPosTags(PatternOffset(2)), LexiconAllPosTags(PatternOffset(3))),ConcatNoNulls(LexiconAllPosTags(PatternOffset(1)), LexiconAllPosTags(PatternOffset(2))))
TokenN1AllPosTags|TokenN2WordForm	IfThenElse(WordForm(PatternOffset(1))=="'",ConcatNoNulls(LexiconAllPosTags(PatternOffset(2)), WordForm(PatternOffset(3))),ConcatNoNulls(LexiconAllPosTags(PatternOffset(1)), WordForm(PatternOffset(2))))
PrevTokenSuffix	NullIf(Not(UnknownWord(PatternOffset(-1))),ConcatNoNulls(NLetterSuffix(PatternOffset(-1),IndexRange(3,5))))
NextTokenSuffix3	IfThenElse(WordForm(PatternOffset(1))=="'",NullIf(Not(UnknownWord(PatternOffset(2))),ConcatNoNulls(NLetterSuffix(PatternOffset(2),3))),NullIf(Not(UnknownWord(PatternOffset(1))),ConcatNoNulls(NLetterSuffix(PatternOffset(1),3))))
NextTokenSuffix4	IfThenElse(WordForm(PatternOffset(1))=="'",NullIf(Not(UnknownWord(PatternOffset(2))),ConcatNoNulls(NLetterSuffix(PatternOffset(2),4))),NullIf(Not(UnknownWord(PatternOffset(1))),ConcatNoNulls(NLetterSuffix(PatternOffset(1),4))))
NextTokenSuffix5	IfThenElse(WordForm(PatternOffset(1))=="'",NullIf(Not(UnknownWord(PatternOffset(2))),ConcatNoNulls(NLetterSuffix(PatternOffset(2),5))),NullIf(Not(UnknownWord(PatternOffset(1))),ConcatNoNulls(NLetterSuffix(PatternOffset(1),5))))
PrevTokenWordForm	ConcatNoNulls(WordForm(PatternOffset(-1)))
TokenP2WordForm|TokenP1WordForm	ConcatNoNulls(WordForm(PatternOffset(-2)), WordForm(PatternOffset(-1)))
NextTokenWordForm	IfThenElse(WordForm(PatternOffset(1))=="'",WordForm(PatternOffset(2)),WordForm(PatternOffset(1)))
TokenN1WordForm|TokenN2WordForm	IfThenElse(WordForm(PatternOffset(1))=="'",ConcatNoNulls(WordForm(PatternOffset(2)), WordForm(PatternOffset(3))),ConcatNoNulls(WordForm(PatternOffset(1)), WordForm(PatternOffset(2))))
FirstWord	OnlyTrue(PatternIndexInSentence()==0)
FirstWordPerWordForm	ConcatNoNulls(WordForm(),ToStringNoNulls(OnlyTrue(PatternIndexInSentence()==0)))
FirstWordOrAfterPunct	PatternIndexInSentence()==0 | NullToFalse(LexiconPosTag(PatternOffset(-1),"PONCT"))
PrevTokenVerbLemma	ConcatNoNulls(LemmaForPosTag(PatternOffset(-1),"V","VS","VIMP","VPP","VINF","VPR"))
PrevVerbLemma	ConcatNoNulls(LemmaForPosTag(BackwardSearch(PatternOffset(-1),LexiconPosTag("V")|LexiconPosTag("VS")|LexiconPosTag("VIMP")|LexiconPosTag("VPP")|LexiconPosTag("VINF")|LexiconPosTag("VPR"), 0, -4),"V","VS","VIMP","VPP","VINF","VPR"))

